000000000000000000000000000000000000111111
000000000000000000000000000000000011101111
000000000000000000000000000000001111111111
000000000000000000000000000000111110001101
000000000000000000000000000001111000111011
000000000000000000000000000011100011100101
000000000000000000000000000111001111001101
000000000000000000000001111110011110011001
000000000000000000000011110001111000111011
000000000110000000001110000111110011100011
000000001111000000111000011111000111100011
000000111001111111110011111100001110000011
000001111000011110000111110000111000001110
000001100111000000011111000111110000001110
000011001111111111111100011111000001111000
000110011111110110000001111100000111100000
000100111110000000111111110000111110000000
001100111100011111111111100001111000000000
011001110001111111111101000111110000000000
010011100111111110000000011111000000000000
111100011111111000000000111110000000000000
111000111111000000000111111000000000000000
110011101110000111111111100000000000000000
101111001100011111000000000000000000000000
111110011000110000000000000000000000000000
011110110011100000000000000000000000000000
001101100111000000000000000000000000000000
000111000110000000000000000000000000000000
000010001110000000000000000000000000000000
